NO                 ./textures/wall_4.xpm
SO ./textures/wall_4.xpm
WE ./textures/wall_4.xpm
EA ./textures/wall_4.xpm


F 127, 127, 0
C 135,  						206,							 100

1111111111111111111111111111
1                          1
1 N                        1
1                          1
1111111111111111111111111111