
NO ./textures/eagle.xpm    
SO ./textures/eagle.xpm
WE ./textures/eagle.xpm   
EA ./textures/eagle.xpm
F 220,100,0
C 0,10,150
SC 50


1111111111111111111111111111
1E                         1
1111111111111111111111111111
