NO ./textures/wall_4.xpm
SO ./textures/wall_4.xpm
WE ./textures/wall_4.xpm
EA ./textures/wall_4.xpm

F 220,100,0
C 0,10,150
 
        1111111111111111111111111
        1000000000110000000000001
        1011000001110000000000001
        1001000000000000000000001
111111111011000001110000000000001
100000000011000001000000111111111111
1111011111111101110000000001
1111011111111101110101000001
1100000011010101110000000001
10000000000000000000000000001
1000000000000000000101000001
100000000000000000000000000011111
10000000000000000001011111111111000001
10000000000000000000000000001
100001111000000000010111111111000001
10000111100000000000000000001
1000011110000000000101000001
10000000000000000000000000001
1000000000000000000101000001
10000000000000000000000000001
1000000000000000000101000001
1100000111010101111101111000111
11110111 1110101 101111010001
11111111 1111111 111111111111
