        1111111111111111111111111
        1000000000110000000000001
        1011000001110000000000001
        1001000000000000000000001
111111111011000000000000000000001
100000000011000000000000111111111       1111111111111111111111111
10000000000000000000000000001           1                       1
10000000000000000000000000001           1                       1
10000000000000000000000000001111111111111           1           1
1000000000000000000000000000000000000              111          1
10000000000000000000000000001111111111111           1           1
10000000011111110000000000001           1                       1
1000000001111111110000000011            1                       1
1000000001111111110000000001            111111111       111111111
10000000011111110000000000001                   1       1
1000000000000000000000000000111111111111111111111       1
10000000000000000000000000001                           1
1000000000000000000000000000                            1
10000000000000000000000000001                           1
1000000000000000000000000000111111111111111111111       1
11000001110000011110000000111                   1       1
11000111 1000001 100000000001                   1       1
111111111       1 111111111111                  1       111111111111111111111111111111111
        1       1                               1                                       1
        1                                                                               1
        1                                                                               1
        1       1                               1       111111111               111111111
        1       1                               1       1       1                       1
111111111       11111111111111111               1       1       1                       1
1                               1               1       1       1                       1
1                               1               1       1       1                       1
1     S         1111111         1               1       1       1111111111111111111111111
1                               1111111   1111111       1
1                                                       1
1            11111111           1                       1
1                               11111111111111111       11111111111111111                
1                               1               1                       1
1                               1               1                       1
1                               1               1                       1111111
1                               1               1        111111               1
111111111            111111111111               1        11               11111
        1            1                          1         1111             1
        1             1                         1            11           1
        1              1                                                1
        1               1                                               1
        111111111        1                      1               111111111
                1         1                     1               1
                1          1                    1               1
                1          111111               1               1
                1               1               1               11111111111111111
                1               11111111  1111111                               1
                1                                                               1
                1                                                               1
                1                                                               1
11111111111111111           11111111111111111111111111111111111111111111111111111
1                                       1
1                                       1
1                                       1
1                1111111111             111111
1                1        1                  1
1           111111        1                  1
1           1             11111111111111111111
1111111111111





NO ./textures/wall_1.xpm    
SO ./textures/wall_2.xpm
WE ./textures/wall_3.xpm   
EA ./textures/wall_4.xpm
F 220,100,0
C 0,10,150
SC 50