        1111111111111111111111111
        1000000000110000000000001
        1011000001110000000000001
        1001000000000000000000001
111111111011000000000000000000001
100000000011000000000000111111111       1111111111111111111111111
10000000000000000000000000001           1                       1
10000000000000000000000000001           1                       1
10000000000000000000000000001111111111111           1           1
1000000000000000000000000000000000000              111          1
10000000000000000000000000001111111111111           1           1
10000000011111110000000000001           1                       1
1000000001111111110000000011            1                       1
1000000001111111110000000001            111111111       111111111
10000000011111110000000000001                   1       1
10000000000000000000000000001                   1       1
10000000000000000000000000001                   1       1
10000000000000000000000000001                   1       1
10000000000000000000000000001                   1       1
10000000000000000000000000001                   1       1
11000001110000011110000000111                   1       1
11000111 1000001 100000000001                   1       1
111111111       1 111111111111                  1       1
        1       1                               1       1
        1       1                               1       1
        1       1                               1       1
        1       1                               1       1
        1       1                               1       1
111111111       11111111111111111               1       1
1                               1               1       1
1                               1               1       1
1     S                         1               1       1
1                               11111111111111111       1
1                                                       1
1            11111111                                   1
1                               1111111111111111111111111
1                               1
1                               1
1                               1
1                               1
111111111111111111111111111111111



NO ./ruta_a_la_textura_norte
SO ./ruta_a_la_textura_sur
WE ./ruta_a_la_textura_oeste
EA ./ruta_a_la_textura_este
F 220,100,0
C 225,30,0
SC 50